Team,Season,Rank,P,W,D,L,GF,GA,GD,HW,HGF,HGA,AW,AGF,AGA,PTS,H_Att,A_Att,H_Def,A_Def,CS,YC,RC
Arsenal,13,4,38,21,10,7,72,37,35,11,47,23,10,25,14,73,1.587837837837838,1.061571125265393,0.9766454352441614,0.47297297297297297,14,40,5
Aston Villa,13,15,38,10,11,17,47,69,-22,5,23,28,5,24,41,41,0.7770270270270271,1.019108280254777,1.1889596602972399,1.3851351351351353,5,70,3
Chelsea,13,3,38,22,9,7,75,39,36,12,41,16,10,34,23,75,1.3851351351351353,1.4437367303609343,0.6794055201698513,0.7770270270270271,14,49,3
Everton,13,6,38,16,15,7,55,40,15,12,33,17,4,22,23,63,1.114864864864865,0.9341825902335457,0.7218683651804672,0.7770270270270271,11,57,3
Fulham,13,12,38,11,10,17,50,60,-10,7,28,30,4,22,30,43,0.9459459459459459,0.9341825902335457,1.2738853503184715,1.0135135135135136,8,48,3
Liverpool,13,7,38,16,13,9,71,43,28,9,33,16,7,38,27,61,1.114864864864865,1.6135881104033971,0.6794055201698513,0.9121621621621622,16,54,2
Manchester City,13,2,38,23,9,6,66,34,32,14,41,15,9,25,19,78,1.3851351351351353,1.061571125265393,0.6369426751592357,0.6418918918918919,18,63,3
Manchester Utd,13,1,38,28,5,5,86,43,43,16,45,19,12,41,24,89,1.5202702702702702,1.7409766454352442,0.8067940552016986,0.8108108108108107,13,57,1
Newcastle Utd,13,16,38,11,8,19,45,68,-23,9,24,31,2,21,37,41,0.8108108108108107,0.8917197452229301,1.316348195329087,1.25,6,69,4
Norwich City,13,11,38,10,14,14,41,58,-17,8,25,20,2,16,38,44,0.8445945945945946,0.6794055201698513,0.8492569002123141,1.2837837837837838,10,60,1
QP Rangers,13,20,38,4,13,21,30,60,-30,2,13,28,2,17,32,25,0.4391891891891892,0.7218683651804672,1.1889596602972399,1.0810810810810811,7,58,3
Reading,13,19,38,6,10,22,43,73,-30,4,23,33,2,20,40,28,0.7770270270270271,0.8492569002123141,1.4012738853503186,1.3513513513513513,5,45,1
Southampton,13,14,38,9,14,15,49,60,-11,6,26,24,3,23,36,41,0.8783783783783784,0.9766454352441614,1.019108280254777,1.2162162162162162,7,43,2
Stoke City,13,13,38,9,15,14,34,45,-11,7,21,22,2,13,23,42,0.7094594594594595,0.5520169851380042,0.9341825902335457,0.7770270270270271,12,73,4
Sunderland,13,17,38,9,12,17,41,54,-13,5,20,19,4,21,35,39,0.6756756756756757,0.8917197452229301,0.8067940552016986,1.1824324324324325,11,60,3
Swansea City,13,9,38,11,13,14,47,51,-4,6,28,26,5,19,25,46,0.9459459459459459,0.8067940552016986,1.1040339702760085,0.8445945945945946,10,56,2
Tottenham,13,5,38,21,9,8,66,46,20,11,29,18,10,37,28,72,0.9797297297297298,1.5711252653927814,0.7643312101910827,0.9459459459459459,9,54,2
West Bromwich,13,8,38,14,7,17,53,57,-4,9,32,25,5,21,32,49,1.0810810810810811,0.8917197452229301,1.061571125265393,1.0810810810810811,8,62,4
West Ham Utd,13,10,38,12,10,16,45,53,-8,9,34,22,3,11,31,46,1.1486486486486487,0.46709129511677283,0.9341825902335457,1.0472972972972974,11,74,1
Wigan,13,18,38,9,9,20,47,73,-26,4,26,39,5,21,34,36,0.8783783783783784,0.8917197452229301,1.6560509554140128,1.1486486486486487,5,66,2
Arsenal,14,4,38,24,7,7,68,41,27,13,36,11,11,32,30,79,1.2040133779264213,1.4096916299559472,0.4845814977973569,1.0033444816053512,17,51,4
Aston Villa,14,15,38,10,8,20,39,61,-22,6,22,29,4,17,32,38,0.7357859531772576,0.748898678414097,1.2775330396475773,1.0702341137123745,9,78,0
Cardiff City,14,20,38,7,9,22,32,74,-42,5,20,35,2,12,39,30,0.6688963210702341,0.5286343612334802,1.5418502202643172,1.3043478260869565,7,49,1
Chelsea,14,3,38,25,7,6,71,27,44,15,43,11,10,28,16,82,1.4381270903010033,1.2334801762114538,0.4845814977973569,0.5351170568561873,18,54,3
Crystal Palace,14,11,38,13,6,19,33,48,-15,8,18,23,5,15,25,45,0.6020066889632106,0.6607929515418502,1.013215859030837,0.8361204013377928,12,59,2
Everton,14,5,38,21,9,8,61,39,22,13,38,19,8,23,20,72,1.2709030100334449,1.013215859030837,0.8370044052863437,0.6688963210702341,15,54,1
Fulham,14,19,38,9,5,24,40,85,-45,5,24,38,4,16,47,32,0.8026755852842808,0.7048458149779736,1.6740088105726874,1.5719063545150502,5,56,1
Hull City,14,16,38,10,7,21,38,53,-15,7,20,21,3,18,32,37,0.6688963210702341,0.7929515418502202,0.9251101321585904,1.0702341137123745,10,52,4
Liverpool,14,2,38,26,6,6,101,50,51,16,53,18,10,48,32,84,1.7725752508361203,2.1145374449339207,0.7929515418502202,1.0702341137123745,10,53,1
Manchester City,14,1,38,27,5,6,102,37,65,17,63,13,10,39,24,86,2.1070234113712374,1.7180616740088108,0.5726872246696035,0.8026755852842808,16,72,1
Manchester Utd,14,7,38,19,7,12,64,43,21,9,29,21,10,35,22,64,0.9698996655518395,1.5418502202643172,0.9251101321585904,0.7357859531772576,13,64,3
Newcastle Utd,14,10,38,15,4,19,43,59,-16,8,23,28,7,20,31,49,0.7692307692307693,0.8810572687224669,1.2334801762114538,1.0367892976588629,10,51,6
Norwich City,14,18,38,8,9,21,28,62,-34,6,17,18,2,11,44,33,0.568561872909699,0.4845814977973569,0.7929515418502202,1.4715719063545152,12,61,2
Southampton,14,8,38,15,11,12,54,46,8,8,32,23,7,22,23,56,1.0702341137123745,0.9691629955947137,1.013215859030837,0.7692307692307693,15,60,0
Stoke City,14,9,38,13,11,14,45,52,-7,10,27,17,3,18,35,50,0.903010033444816,0.7929515418502202,0.748898678414097,1.1705685618729096,9,69,5
Sunderland,14,14,38,10,8,20,41,60,-19,5,21,27,5,20,33,38,0.7023411371237459,0.8810572687224669,1.1894273127753305,1.1036789297658862,11,67,7
Swansea City,14,12,38,11,9,18,54,54,0,6,33,26,5,21,28,42,1.1036789297658862,0.9251101321585904,1.145374449339207,0.9364548494983277,8,53,3
Tottenham,14,6,38,21,6,11,55,51,4,11,30,23,10,25,28,69,1.0033444816053512,1.1013215859030838,1.013215859030837,0.9364548494983277,14,66,4
West Bromwich,14,17,38,7,15,16,43,59,-16,4,24,27,3,19,32,36,0.8026755852842808,0.8370044052863437,1.1894273127753305,1.0702341137123745,7,67,0
West Ham Utd,14,13,38,11,7,20,40,51,-11,7,25,26,4,15,25,40,0.8361204013377928,0.6607929515418502,1.145374449339207,0.8361204013377928,14,59,5
Arsenal,15,3,38,22,9,7,71,36,35,12,41,14,10,30,22,75,1.4642857142857144,1.4457831325301205,0.6746987951807228,0.7857142857142858,13,67,2
Aston Villa,15,17,38,10,8,20,31,57,-26,5,18,25,5,13,32,38,0.6428571428571429,0.6265060240963856,1.2048192771084338,1.1428571428571428,10,66,7
Burnley,15,19,38,7,12,19,28,53,-25,4,14,21,3,14,32,33,0.5,0.6746987951807228,1.0120481927710845,1.1428571428571428,10,63,2
Chelsea,15,1,38,26,9,3,73,32,41,15,36,9,11,37,23,87,1.2857142857142858,1.7831325301204821,0.43373493975903615,0.8214285714285715,17,72,4
Crystal Palace,15,10,38,13,9,16,47,51,-4,6,21,27,7,26,24,48,0.7500000000000001,1.2530120481927711,1.3012048192771084,0.8571428571428571,7,59,4
Everton,15,11,38,12,11,15,48,50,-2,7,27,21,5,21,29,47,0.9642857142857143,1.0120481927710845,1.0120481927710845,1.0357142857142858,10,64,2
Hull City,15,18,38,8,11,19,33,51,-18,5,19,24,3,14,27,35,0.6785714285714286,0.6746987951807228,1.1566265060240963,0.9642857142857143,10,72,6
Leicester City,15,14,38,11,8,19,46,55,-9,7,28,22,4,18,33,41,1.0,0.8674698795180723,1.0602409638554218,1.1785714285714286,10,49,4
Liverpool,15,6,38,18,8,12,52,48,4,10,30,20,8,22,28,62,1.0714285714285714,1.0602409638554218,0.963855421686747,1.0,14,64,3
Manchester City,15,2,38,24,7,7,83,38,45,14,44,14,10,39,24,79,1.5714285714285716,1.879518072289157,0.6746987951807228,0.8571428571428571,14,75,2
Manchester Utd,15,4,38,20,10,8,62,37,25,14,41,15,6,21,22,70,1.4642857142857144,1.0120481927710845,0.7228915662650602,0.7857142857142858,11,62,5
Newcastle Utd,15,15,38,10,9,19,40,63,-23,7,26,27,3,14,36,39,0.9285714285714286,0.6746987951807228,1.3012048192771084,1.2857142857142858,8,59,7
QP Rangers,15,20,38,8,6,24,42,73,-31,6,23,24,2,19,49,30,0.8214285714285715,0.9156626506024097,1.1566265060240963,1.7500000000000002,6,73,3
Southampton,15,7,38,18,6,14,54,33,21,11,37,13,7,17,20,60,1.3214285714285716,0.819277108433735,0.6265060240963856,0.7142857142857143,15,56,3
Stoke City,15,9,38,15,9,14,48,45,3,10,32,22,5,16,23,54,1.1428571428571428,0.7710843373493976,1.0602409638554218,0.8214285714285715,9,79,1
Sunderland,15,16,38,7,17,14,31,53,-22,4,16,27,3,15,26,38,0.5714285714285714,0.7228915662650602,1.3012048192771084,0.9285714285714286,13,94,2
Swansea City,15,8,38,16,8,14,46,49,-3,9,27,22,7,19,27,56,0.9642857142857143,0.9156626506024097,1.0602409638554218,0.9642857142857143,13,45,5
Tottenham,15,5,38,19,7,12,58,53,5,10,31,24,9,27,29,64,1.1071428571428572,1.3012048192771084,1.1566265060240963,1.0357142857142858,9,78,4
West Bromwich,15,13,38,11,11,16,38,51,-13,7,24,26,4,14,25,44,0.8571428571428571,0.6746987951807228,1.2530120481927711,0.892857142857143,16,64,3
West Ham Utd,15,12,38,12,11,15,44,47,-3,9,25,18,3,19,29,47,0.892857142857143,0.9156626506024097,0.8674698795180723,1.0357142857142858,9,64,2
Arsenal,16,2,38,20,11,7,65,36,29,12,31,11,8,34,25,71,1.09347442680776,1.4814814814814814,0.4793028322440087,0.8818342151675486,18,38,4
Aston Villa,16,20,38,3,8,27,27,76,-49,2,14,35,1,13,41,17,0.4938271604938271,0.5664488017429193,1.5250544662309367,1.4462081128747795,6,74,3
Bournemouth,16,16,38,11,9,18,45,67,-22,5,23,34,6,22,33,42,0.8112874779541446,0.9586056644880174,1.4814814814814814,1.164021164021164,7,53,1
Chelsea,16,10,38,12,14,12,59,53,6,5,32,30,7,27,23,50,1.128747795414462,1.176470588235294,1.3071895424836601,0.8112874779541446,9,56,5
Crystal Palace,16,15,38,11,9,18,39,51,-12,6,19,23,5,20,28,42,0.6701940035273368,0.8714596949891067,1.0021786492374727,0.9876543209876542,8,59,2
Everton,16,11,38,11,14,13,59,55,4,6,35,30,5,24,25,47,1.2345679012345678,1.045751633986928,1.3071895424836601,0.8818342151675486,10,41,5
Leicester City,16,1,38,23,12,3,68,36,32,12,35,18,11,33,18,81,1.2345679012345678,1.4379084967320261,0.784313725490196,0.6349206349206349,15,45,3
Liverpool,16,8,38,16,12,10,63,50,13,8,33,22,8,30,28,60,1.164021164021164,1.3071895424836601,0.9586056644880174,0.9876543209876542,11,58,3
Manchester City,16,4,38,19,9,10,71,41,30,12,47,21,7,24,20,66,1.657848324514991,1.045751633986928,0.9150326797385621,0.7054673721340388,16,61,0
Manchester Utd,16,5,38,19,9,10,49,35,14,12,27,9,7,22,26,66,0.9523809523809523,0.9586056644880174,0.392156862745098,0.9171075837742504,18,64,1
Newcastle Utd,16,18,38,9,10,19,44,65,-21,7,32,24,2,12,41,37,1.128747795414462,0.522875816993464,1.045751633986928,1.4462081128747795,8,58,5
Norwich City,16,19,38,9,7,22,39,67,-28,6,26,30,3,13,37,34,0.9171075837742504,0.5664488017429193,1.3071895424836601,1.3051146384479717,5,60,3
Southampton,16,6,38,18,9,11,59,41,18,11,39,22,7,20,19,63,1.3756613756613756,0.8714596949891067,0.9586056644880174,0.6701940035273368,12,54,6
Stoke City,16,9,38,14,9,15,41,55,-14,8,22,24,6,19,31,51,0.7760141093474426,0.8278867102396513,1.045751633986928,1.09347442680776,10,50,4
Sunderland,16,17,38,9,12,17,48,62,-14,6,23,20,3,25,42,39,0.8112874779541446,1.0893246187363834,0.8714596949891067,1.4814814814814816,7,62,2
Swansea City,16,12,38,12,11,15,42,52,-10,8,20,20,4,22,32,47,0.7054673721340388,0.9586056644880174,0.8714596949891067,1.128747795414462,9,60,1
Tottenham,16,3,38,19,13,6,69,35,34,10,35,15,9,34,20,70,1.2345679012345678,1.4814814814814814,0.6535947712418301,0.7054673721340388,13,72,0
Watford,16,13,38,12,9,17,40,50,-10,6,20,19,6,20,31,45,0.7054673721340388,0.8714596949891067,0.8278867102396513,1.09347442680776,11,73,3
West Bromwich,16,14,38,10,13,15,34,48,-14,6,20,26,4,14,22,43,0.7054673721340388,0.6100217864923746,1.1328976034858387,0.7760141093474426,11,65,3
West Ham Utd,16,7,38,16,14,8,65,51,14,9,34,26,7,31,25,62,1.199294532627866,1.3507625272331154,1.1328976034858387,0.8818342151675486,11,57,5
Arsenal,17,5,38,23,6,9,77,44,33,14,39,16,9,38,28,75,1.2850082372322902,1.663019693654267,0.7002188183807438,0.9225700164744646,13,68,3
Bournemouth,17,9,38,12,10,16,55,67,-12,9,35,29,3,20,38,46,1.1532125205930808,0.8752735229759299,1.2691466083150984,1.2520593080724878,10,50,3
Burnley,17,16,38,11,7,20,39,55,-16,10,26,20,1,13,35,40,0.85667215815486,0.5689277899343544,0.8752735229759299,1.1532125205930808,10,64,2
Chelsea,17,1,38,30,3,5,85,33,52,17,55,17,13,30,16,93,1.812191103789127,1.312910284463895,0.7439824945295405,0.5271828665568369,16,72,0
Crystal Palace,17,14,38,12,5,21,50,63,-13,6,24,25,6,26,38,41,0.7907742998352554,1.1378555798687089,1.0940919037199124,1.2520593080724878,7,78,0
Everton,17,7,38,17,10,11,62,44,18,13,42,16,4,20,28,61,1.383855024711697,0.8752735229759299,0.7002188183807438,0.9225700164744646,13,70,2
Hull City,17,18,38,9,7,22,37,80,-43,8,28,35,1,9,45,34,0.9225700164744646,0.3938730853391684,1.5317286652078774,1.4827018121911038,5,67,5
Leicester City,17,12,38,12,8,18,48,63,-15,10,31,25,2,17,38,44,1.0214168039538716,0.7439824945295405,1.0940919037199124,1.2520593080724878,9,72,1
Liverpool,17,4,38,22,10,6,78,42,36,12,45,18,10,33,24,76,1.4827018121911038,1.4442013129102844,0.7877461706783369,0.7907742998352554,12,54,0
Manchester City,17,3,38,23,9,6,80,39,41,11,37,17,12,43,22,78,1.2191103789126854,1.8818380743982492,0.7439824945295405,0.7248764415156508,12,71,4
Manchester Utd,17,6,38,18,15,5,54,29,25,8,26,12,10,28,17,69,0.85667215815486,1.225382932166302,0.5251641137855579,0.5601317957166392,17,77,2
Middlesbrough,17,19,38,5,13,20,27,53,-26,4,17,23,1,10,30,28,0.5601317957166392,0.43763676148796493,1.0065645514223194,0.9884678747940693,11,76,1
Southampton,17,8,38,12,10,16,41,48,-7,6,17,21,6,24,27,46,0.5601317957166392,1.0503282275711159,0.9190371991247265,0.8896210873146623,14,58,2
Stoke City,17,13,38,11,11,16,41,56,-15,7,24,24,4,17,32,44,0.7907742998352554,0.7439824945295405,1.0503282275711159,1.0543657331136738,11,69,2
Sunderland,17,20,38,6,6,26,29,69,-40,3,16,34,3,13,35,24,0.5271828665568369,0.5689277899343544,1.487964989059081,1.1532125205930808,6,75,4
Swansea City,17,15,38,12,5,21,45,70,-25,8,27,34,4,18,36,41,0.8896210873146623,0.7877461706783369,1.487964989059081,1.186161449752883,8,56,0
Tottenham,17,2,38,26,8,4,86,26,60,17,47,9,9,39,17,86,1.5485996705107086,1.7067833698030634,0.3938730853391684,0.5601317957166392,17,62,0
Watford,17,17,38,11,7,20,40,68,-28,8,25,29,3,15,39,40,0.8237232289950578,0.6564551422319475,1.2691466083150984,1.2850082372322902,7,81,5
West Bromwich,17,10,38,12,9,17,43,51,-8,9,27,22,3,16,29,45,0.8896210873146623,0.7002188183807438,0.962800875273523,0.955518945634267,6,80,0
West Ham Utd,17,11,38,12,9,17,47,64,-17,7,19,31,5,28,33,45,0.6260296540362439,1.225382932166302,1.3566739606126914,1.0873146622734762,10,74,5
Arsenal,18,6,38,19,6,13,74,51,23,15,54,20,4,20,31,63,1.8556701030927834,0.9174311926605504,0.9174311926605504,1.0652920962199313,13,57,2
Bournemouth,18,12,38,11,11,16,45,61,-16,7,26,30,4,19,31,44,0.8934707903780068,0.8715596330275229,1.3761467889908257,1.0652920962199313,6,54,1
Brighton & Hove,18,15,38,9,13,16,34,54,-20,7,24,25,2,10,29,40,0.8247422680412371,0.4587155963302752,1.146788990825688,0.9965635738831615,10,54,2
Burnley,18,7,38,14,12,12,36,39,-3,7,16,17,7,20,22,54,0.549828178694158,0.9174311926605504,0.7798165137614679,0.7560137457044673,12,65,0
Chelsea,18,5,38,21,7,10,62,38,24,11,30,16,10,32,22,70,1.0309278350515463,1.4678899082568806,0.7339449541284403,0.7560137457044673,16,40,4
Crystal Palace,18,11,38,11,11,16,45,55,-10,7,29,27,4,16,28,44,0.9965635738831615,0.7339449541284403,1.238532110091743,0.9621993127147765,9,72,0
Everton,18,8,38,13,10,15,44,58,-14,10,28,22,3,16,36,49,0.9621993127147765,0.7339449541284403,1.0091743119266054,1.2371134020618555,10,49,3
Huddersfield,18,16,38,9,10,19,28,58,-30,6,16,25,3,12,33,37,0.549828178694158,0.5504587155963302,1.146788990825688,1.134020618556701,10,59,3
Leicester City,18,9,38,12,11,15,56,60,-4,7,25,22,5,31,38,47,0.859106529209622,1.4220183486238531,1.0091743119266054,1.3058419243986255,9,48,5
Liverpool,18,4,38,21,12,5,84,38,46,12,45,10,9,39,28,75,1.5463917525773194,1.7889908256880735,0.4587155963302752,0.9621993127147765,17,44,1
Manchester City,18,1,38,32,4,2,106,27,79,16,61,14,16,45,13,100,2.0962199312714778,2.0642201834862384,0.6422018348623852,0.4467353951890034,18,57,2
Manchester Utd,18,2,38,25,6,7,68,28,40,15,38,9,10,30,19,81,1.3058419243986255,1.3761467889908257,0.4128440366972477,0.6529209621993127,19,64,1
Newcastle Utd,18,10,38,12,8,18,39,47,-8,8,21,17,4,18,30,44,0.7216494845360825,0.8256880733944953,0.7798165137614679,1.0309278350515463,9,51,2
Southampton,18,17,38,7,15,16,37,56,-19,4,20,26,3,17,30,36,0.6872852233676975,0.7798165137614679,1.1926605504587156,1.0309278350515463,8,62,2
Stoke City,18,19,38,7,12,19,35,68,-33,5,20,30,2,15,38,33,0.6872852233676975,0.6880733944954128,1.3761467889908257,1.3058419243986255,6,62,1
Swansea City,18,18,38,8,9,21,28,56,-28,6,17,24,2,11,32,33,0.5841924398625429,0.5045871559633027,1.1009174311926604,1.099656357388316,9,51,1
Tottenham,18,3,38,23,8,7,74,36,38,13,40,16,10,34,20,77,1.374570446735395,1.5596330275229358,0.7339449541284403,0.6872852233676975,16,49,2
Watford,18,14,38,11,8,19,44,64,-20,7,27,31,4,17,33,41,0.9278350515463917,0.7798165137614679,1.4220183486238531,1.134020618556701,9,62,4
West Bromwich,18,20,38,6,13,19,31,56,-25,3,21,29,3,10,27,31,0.7216494845360825,0.4587155963302752,1.3302752293577982,0.9278350515463917,10,73,1
West Ham Utd,18,13,38,10,12,16,48,68,-20,7,24,26,3,24,42,42,0.8247422680412371,1.1009174311926604,1.1926605504587156,1.443298969072165,10,72,2
